################################################################
#                               #                              #
#            #                  #                 #            #
#  ###      ###                                  ###       ### #
#          #####    ###                  ###    #####          #
####               #   #                #   #               ####
#                 ############################                 #
#                               #                              #
##     ##                       #                      ##     ##
#      ##                       #                      ##      #
#    # ## #   ###               #              ###   # ## #    #
#    ######   #######                       ######   ######    #
#                                                              #
#                   ###                  ###                   #
#    ######        #   #                #   #         #####    #
#    #    #       #     ################     #        #   #    #
#             #                                   #            #
#                                                              #
#    #     #    ################################    #     #    #
#                                                              #
#####                           #                          #####
######      #####               #              #####      ######
#######                                                  #######
########                                                ########
################################################################